BottomRightShadowBorder -> i:
Color -> l:
CircleBorder -> k:
SimpleBorder -> ab:
FadeInBackground -> n:
TopBorder -> ag:
ThinSimpleBackground -> ad:
BorderedRoundRectOpeningBackground -> e:
BorderedRoundRectBackground -> d:
RightBorder -> w:
PulsatingBackground -> t:
HorizontalStripesBackground -> p:
OpeningBackground -> s:
TranslucentSimpleBackground -> ai:
DropShadowBorder -> m:
BallBackground -> b:
ImageBackground -> q:
PulsatingCircleBackground -> u:
Background -> a:
RoundTabBackground -> z:
SmoothColorBackground -> ac:
Web20RoundRectBackground -> aj:
TopBottomLeftRightBorder -> ah:
RoundRectBackground -> x:
BottomBorder -> h:
BorderedRoundTabBackground -> f:
GradientVerticalBackground -> o:
PulsatingCirclesBackground -> v:
XmasSnowBackground -> ak:
SimpleBackground -> aa:
TigerStripesBackground -> ae:
BorderedSimpleBackground -> g:
CircleBackground -> j:
TiledImageBackground -> af:
LeftBorder -> r:
RoundRectBorder -> y:
Border -> c:
